0000000000000000000000000000000000000000000010000000000000000000
0000000000000000000000000000000000000000000001000000000000000000
0000000000000000000000000000000000000000000000111111100000000000
0000000000000000000000000000000000000000000002221111110000000000
0000000000000000000000000000000000000000111111121111220000000000
0000000000000000000000000000000000000111000001121112211111111111
0000000000000000000000111111111111000000000001121122110000000000
0000000000000000000111000000000000000000000001121221110000000000
0000000000000000000000000000000000000000000001122211110000000000
0000000000000000100000000000000000000000000001111111110000000000
0000000001111111100000000000000000000000000000111111100000000000
0000000000000000000000000000000000000000000000000000000000000000
1100000000000000000000000000000000000000000000000000000000000000
0000000000000000000000000000000000000000000000000000000000000000
0000000000000000000000000000000000000000000000000000000000000000
0000000000000000000000000000000000000000000000000000000000000000
0001000000000000000000000000000000000000000000000000000000000000
0000111222200000000000000000000000000000000000000000000000000000
0000000000000000000000000000000000000000000000000000000000000000
0000100000000000000000000000000000000000000000000000000000000000
0000011111111111110000000000000000000000000000000000000000000000
0000000000000000000000000000000000000000000000000000000000000000
0000000000000000000000000000000000000000000000000000000000000000
0000000000000000000001000000000000000000000000000000000000000000
0000000000000000000000111000000000000000000000000000000000000000
0000000000000000000000001000000000000000000000000000000000000000
0000000000000000000000001111111111111100000000000000000000000000
0000000000000000000000000000000000000100000000000000000000000000
0000000000000000000000000000000000000100100000001111110000000000
0000000000000000000000000000000000000100011122110000000000000000
0000000000000000000000000000000000000100000000000000000000000000
0000000011111111111000000000000000000100000000000000000000000000
0000000000000000000111110000000000000100000000000000000011111110
0000000000000000000000001100000000000000000000000000000000000000
0111111000000000000000000011000000000000000000000000000000000000
0000000000000000000000000000110000000000000000000000000000000000
0000000000000000000000000000001100000000000000000000000000000000
0000001000000000000000000000000011000000000000022111111000000000
0000001122211110000000000000000000100000000000200000000000000000
0000000000000000000000000000000000100000000002000000000000000000
0000000000000000000000000000000000111111111120000000000000000000
0000000000000000000000000000000000100000000000000000000000000000
0000000000000000000000000000000000100000000000000000000000000000
0000000000000000000111110000000000100000000000111111000000000000
0000000000000000000000000000000000100000000000000000000000000000
1111111111000000000000000000000000100000000000000000000000000000
0000000000110000000000000000000000100000000000000000000000000000
0000000000001111111111111122221111111111111111111111111111111111
0000000000000000000000000000000000000000000000010000000000000000
0000000000000000000000000000000000000000000000010000000000000000
1111111110000000000000000000000000000000000000010000000000000000