00000000000000000000000000000000
02002002200200200202020222020020
02002020020200200202020020022020
00222020020200200202020020020220
00002020020200200202020020020020
00220002200022000020200222020020
